#####################################
#...................................#
#....t..............................#
#...............$...................#
#...................................#
#.....$.............................#
#......$..............s.............#
#...................................#
#...................................#
#.....s.........$...................#
#........................t..........#
#.......$...........................#
#...................................#
#...................................#
#####################################
