#                                   #
#                                   #
#                                   #
#                                   #
#                                   #
#                                   #
#     $                             #
#                                   #
#             $                     #
#                                $  #
#                                   #
#                                   #
#                                   #
.....................................
